111111111111111111111111111111
100000000000011000000000000111
101111011111011011111011110111
101111011111011011111011110111
101111011111011011111011110111
100000000000000000000000000111
101111011011111111011011110111
101111011011111111011011110111
100000011000011000011000000111
111111011111011011111011111111
111111011111011011111011111111
111111011000000000011011111111
111111011011100111011011111111
100000000010000001000000000011
100000000010000001000000000011
111111011011100111011011111111
111111011000000000011011111111
111111011011111111011011111111
111111011011111111011011111111
100000000000011000000000000111
101111011111011011111011110111
101111011111011011111011110111
100011000000000000000011000111
111011011011111111011011011111
111011011011111111011011011111
100000011000011000011000000111
101111111111011011111111110111
101111111111011011111111110111
100000000000000000000000000111
111111111111111111111111111111