111111111111111111111111111111
100000000000000000000000000001
100000000100000000000000000001
100100000000000000001000000001
100000000000000000000000000001
100000000000000000000000000001
100000000000000000000000000001
100000100000000010000000100001
100000000000000000000000000001
100000000000000000000000000001
100000000010000000000000000001
100000000000000000000000000001
100000000000000000000000000001
100001000000000000000010000001
100000000000000000000000000001
100000000000000000000000000001
100000000000000001000000000001
100000000000000000000000100001
100000000000010000000000000001
100000000000000000000000000001
100000000000000000000000010001
100000000000000000001000000001
100000010000000000000000000001
100000000000000000000000000001
100000000000000000000001000001
100000000000000000000010000001
100000000000001000000000000001
100000000000000000000000000001
111111111111111111111111111111
